XXXXXXXXXX
XXSXX    X
XX XX X XX
XX XX X XX
X     X XX
XX XXXX XX
XX X XX XX
XX       X
XG X XX XX
XX  XXXXXX
XXXXXXXXXX