XXXXXXXXXXX
XXSXXXXX XX
XX XXXXX XX
XX XXXXX XX
XX XXXXX XX
XX       XX
XX   XXX XX
XX       XX
XX  X XXXXX
XX  X XXXXX
XX XX XX XX
XX XX XX XX
XX XGXXXXXX
XX   XXXXXX
XXXXXXXXXXX