XXXXXXXXXXXXXXXXXXXXXXXXXXXXXXXXXXXXXXXXXXXXXXXXXXXXXXXXXXXXXXXXXXXXXXXXXXX
XX XXXXXXXXXXXXXXXXXXXXXXXXXXXXXXXXXXXXXXXXXXXXXXXXXXXXXXXXXXXXXXXXXXXXXXXX
XX XXXXXXXXXXX                    X                                     XXX
X           XXXXXXXXX XXXXXXXXXXX X XXXXXXXXXXXXXXXXXXXXX XXXXXXXXXXXXX XXX
XX XXXXXXXX XXXXXXXXX X   X     X X X                   X XX XXX    X X XXX
XX XX   XXX         X X X X XXX X X X XXXXXXXXXXXXXXXXXXX XX     XX X X XXX
XX XX X XXX XXXXXXX X X X X X X X X X                     XX XXX XXXX X XXX
XXXXX X XXX X       X X XXX X X X X XXXXXXXXX XXXXXXXXXXX XX XXX XX X X XXX
XXXXX X    SX XXXXXXX X     X X X X XX    XXX XX XXXXXXXX XXXXXX XX X X XXX
XXXXX XXXXX X      XX X XXX X X X X XX XX XXX XX       XX        XX X X XXX
XXXXXXXXXXX XXXXXX XX X X X X X X X XX X    X XX XXXXX XXXXXXXXXXXX X X XXX
XX               X XX X X X X X X X XX XX XXX      XXXXXXXXXXXXXXXX X X XXX
XX XXXXXXXXXXXXX X XX X X X X X X X XX X    X XX XXXX             X X X XXX
XX X           X X XX X X X X X X X XX XXXXXX XX XXXX XXXXXXXXXXX X X X XXX
XX X XXXXXXXXX X X XX X X X X X X X XX        XX XXXX         XXX X X X XXX
XX X X       X X X XX X X X X   X X XXXXXXXXXXXX XXXXXXXXXXXX XXX X X X XXX
XX X XXXXXXX X X X XX X X X XXXXX X XXXXXXXXXXXXXXXXXXXXXXXXX XXX X X X XXX
XX X         X   X  X X   X       X                           XXX X X X XXX
XX XXXXXXXXXXXXXXXXXX XXXXXXXXXXXXXXXXXXXXXXXXXXXXXXXXXXXXXXXXXXX X X X XXX
XX                                                                X X X XXX
XX XXXXXX XXXXXXXXXXX XXXXXXXXXXXXXXXXXXXXXXXXXXXXXXXXXXXXXXXXXXXXX X X XXX
XX XXXX X           X X                              X            X X X XXX
X       XXXXXXXXXXX X XXXXXXXXX XXXXXXXXXXXXXXXXX XXXX X XXXXXXXX X X X XXX
XXXXXXXXXXXXXXXXXXX X X X                              X XX    XX X X X XXX
X                   X X XXXXXXX XXXXXXXXXXXXXXXXX XXXX X XX XXXXX X X X XXX
X XXXXXXXXXXXXXXXXXXX X         X                 XXXX X XX XX XX X X X XXX
X XXXXXXXXXXXXXXXXXXX XXXXXXXXX XXXXXXXXXXXXXXXXX XXXX X XX XX XX X X X XXX
X                   X XX                             X X XX XX XX X X X XXX
XXXXXXXXXXXXXXXXXXX X XX XXXXXX XXXXXXXXXXXXXXXXX XXXX X XX XX XX X X X XXX
XXXXXXXXXXXXXXXXXXX X XX X    X X               X XXXX X XX XX XX X X X XXX
X                   X XX XXXX X X XXXXXXXXXXXXXXX XXXX X XX XX XX X X X XXX
X XXXXXXXXXXXXXXXXXXX XX      X X                 XXXX X XX XX XX X X X XXX
X                   X XXXXXXXXX XXXXXXXXXXXXXXXXX XXXX X XX XX XX X X X XXX
X XXXXX XXXXXXXXXXXXX XX                             X X XX XX XX X X X XXX
X XXXXX X   XX     XX XXXXXXXXX XXXXXXXXXXXXXXXXX XXXX X XX XX XX X X X XXX
X X     X X XX XXX XX X                           XXXX X XX XX XX X X X XXX
X X XXX X X XX X X XX XXXXXXXXX XXXXXXXXXXXXXXXXXXXXXX X XX XX XX X X X XXX
X X X X X X XX X X XX X                                X XX XX XX X X X XXX
X X X X X X XX X X XX X XXXXXXXXXXXXXXXXXXXXXXXXXXXXXX X XX XX XX X X X XXX
X X X X X X XX X X XX X X XXXXXXXXXXXXXXXXXXXXXXXXXXXX X XX XX XX X X X XXX
X X X X X X XX X X XX X X X                         XX X XX XX XX X X X XXX
X X X X X X XX X X XX X X X XXXXXXXXXXXXXXXXXXXXXXX XX X XX XX XX X X X XXX
X X X X X X XX X X XX X X X X                     X XX X XX XX XX X X X XXX
X X X X X X XX X X XX X X X X XXXXXXXXXXXXXXXXXXX X XX X XX XX XX X X X XXX
X X X X X X XX X X XX X X X X XXXXXXXXXXXXXXXXXXX X XX X XX XX XX X X X XXX
X X X X X X XX X X XX X X X X                       XX X XX XX XX X X X XXX
X X X X X X XX X X XX X X X XXXXXXXXXXXXXXXXXXXXXXXXXX X XX XX XX X X X XXX
X X X X X X XX X X XX X X X                            X XX XX XX X X X XXX
X X X X X X XX X X XX X   XXXXXXXXXXXX XXXXXXXXXXXXXXX X XX XX XX X X X XXX
X X X X X X XX X X XX XXXXXXXXXXXXXXXX XXXXXXXXXXXXXXX X XX XX XX X X X XXX
X X X X X X XX X X XX XX                             X X XX XX XX X X X XXX
X X X X X X XX X X XX XX XXXXXXXXXXXXX XXXXXXXXXXXXX X X XX XX XX X X X XXX
X X X X X X XX X X XX XX XX         XX XX         XX X X XX XX XX X X X XXX
X X X X X X XX X X XX XX XX XXX XXX XX XX XXX XXX XX X X XX XX XX X X X XXX
X X X X X X XX X X XX XX XX XXX XXX XX XX XXX XXX XX X X XX XX XX X X X XXX
X X X X X X XX X X XX XX XX XXX XXX XX XX XXX XXX XX X X XX XX XX X X X XXX
X X X X X X XX X X XX XX XX XXX XXX XX XX XXX XXX XX X X XX XX XX X X X XXX
X X X X X X XX X X XX XX XX         XX XX         XX X X XX XX XX X X X XXX
X X X X X X XX X X XX XX XXXXXXXXXXXXX XXXXXXXXXXXXX X X XX XX XX X X X XXX
X X X X X X XX X X XX XX                             X X XX XX XX X X X XXX
X X X X X X XX X X XX XXXXXXXXXXXXXXXXXXXXXXXXXXXXXXXX X XX XX XX X X X XXX
X X X X X X XX X X XX                                  X     X XXXX X X XXX
X X X X X X XX X X XXXXXXXXXXXXXXXXXXXXXXXXXXXXXXXXXXXXXXXXXXX XXXX X X XXX
X X X X X X XX X X X                                             XX X X XXX
X X X X X X XX X X XXXXXXXXXXXXXXXXXXXXXXXXXXXXXXXXXXXXX XXXXX XXXX X X XXX
X X X X X X XX X X X                 X                 X     X X  X X X XXX
X X X X X X XX X X X XXXXXXXXXXXXXXXXX XXXXXXXXXX XXXX X XXX X XX X X X XXX
X X X X X X XX X X X                   X          XXXX X X X X XX X X X XXX
X X X X X X XX X X XXXXXXXXXXXXXXXXXXX XXXXXXXXXX    X X X X X XX X X X XXX
X X X X X X XX X X XXX                         XX XXXX X X X X XX X X X XXX
X X X X X X XX X X XXX XXXXXXXXXXXXXXXXXXXXXXX XX XXXX X X X X XX X X X XXX
X X X X X X XX X X XXX X                   XXX XX    X X X X X XX X X X XXX
X X X X XXX XX X X XXX XXXXXXXXXXXXXXXXXXX XXX XX XXXX X X X X XX X X X XXX
X X X X X    X X X XXX                     XXX XX XXXX X X   X    X X X XXX
X X X X X XX X X X XXX XXXXXXXXXXXXXXXXXXXXXXX XX    X X XXXXX XXXX X X XXX
X X X X X XX X X X XXX X XXXXXXXXXXXXXX      X XX XXXX X X        X X X XXX
X X X X X XX X X X XXX X                X XX X XX XXXX X XX XXXXXXX X X XXX
X X X X X XX X X X XXX X XXXXXXXXXXXXXX X  X X XX XXXX X XX X    XX X X XXX
X X X X X XX X X X XXX XXXXXXXXXXXXXXXX X XX X XX X XX X XX X XX XX X X XXX
X X X X X XX X X X XXX               XX X  X X XX X XX X XX X XX XX X X XXX
X X X X X XX X X X XXXXXXXXXXXXXXXXX XX XXXX X XX X XX X XX X XX XX X X XXX
X X X X X XX X X X XXXXXXXXXXXXXXX X XX XXXX X XX X XX X XX X XX XX X X XXX
X X X X X XX X X X               X X    XX X X XX X XX X XX   XX XX X X XXX
X X X X X XX X X X XXXXXXXXXXXXX X X XX XX X X XX X XX X XX X XX XX X X XXX
X X X X X XX X X X XXXXXXX     X X X XX XX X X XX X XX X XX X XX XX X X XXX
X X X X X XX X X X XXXXXXX XXX X X   XX XX X X XX X XX X XX X XX XX X X XXX
X X X X X XX X X X XX      X X X XXXXXXXXX X X XX X XX X X  X XX XX X X XXX
X X X X X XX X X X XX XXXX X   X           X X XX X XX X XXXX XXXXX X X XXX
X X X X X XX X X X XX XXXX XXXXX XXXXXXXXX X X XX X XX X XX           X XXX
X X X X X XX X X X XX   XX       XX   X  X X X XXXX XX X XX XXXXXXX X X XXX
X X X X X XX X X X XX XXXXXXXXXXXXX X XX X X X      XX X XX XXXXX X X X XXX
X X X X X XX X X X XX             X X XX X X XXXXXX XX X XX       X X X XXX
X X X X X XX X X   XX XXXXXXXXXXXXX X XX X XXXXXXXX XXXX XXXXXXXXXX X X XXX
X X X X X XX X XXXXXX               X XX                              X XXX
X X X X X XX X XXXXXXXXXXXXXXXXXXXXXXGXXXXXXXXXXXXXXXXXXXXXXXXXXXXXXXXX XXX
X X X X X XX X XXXXXXXXXXXXXXXXXXXXXXXXXXXXXXXXXXXXXXXXXXXXXXXXXXXXXXXX XXX
X X X X X XX X XXX                                                      XXX
X X X X X XX X XXX XXXXXXXXXXXXXXXXXXXXXXXXXXXXXXXXXXXXXXXXXXXXXXXXXXXXXXXX
X X X X X XX X XXX X                                                    XXX
X X X X X XX X XXX XXXXXXXXXXXXXXXXXXXXXXXXXXXXXXXXXXXXXXXXXX XXXXXXXXX XXX
X X X X X XX X XXX XXXXXXXXXXXXXXXXXXXXXXXXXXXXXXXXXXXXXXXXXX X X X X X XXX
X X X X X XX X XXX XX                                      XX X X X X X XXX
X X X X X XX X XXX XX XXXXXXXXXXXXXXXXXXXXXXXXXXXXXXXXXXXX XX X X X X X XXX
X X X X X XX X XXX XX XXXXXXXXXXXXXXXX                   X XX X X X X X XXX
X X X X X XX X XXX XX X                XXXXXXXXXXXXXXXXX X XX X X X X X XXX
X X X X X XX X XXX XX X XXXXXXXXXXXXXX X                 X XX X X X X X XXX
X X X X X XX X XXX XX X              X X XXXXXXXXXXXXXXXXX XX X X X X X XXX
X X X X X XX X     XX XXXXXXXXXXXXXXXX XXXXXXXXXXXXXXXXXXX XX X X X X X XXX
X X   X   XX XXXXXXX                                    XX            X XXX
X XXXXXXXXXXXXXXXXXXXXXXXXXXXXXXXXXXXXXXXXXXXXXXXXXXXXXXXXXXXXXXXXXXXXX XXX
X                                                                       XXX
XXXXXXXXXXXXXXXXXXXXXXXXXXXXXXXXXXXXXXXXXXXXXXXXXXXXXXXXXXXXXXXXXXXXXXXXXXX
XXXXXXXXXXXXXXXXXXXXXXXXXXXXXXXXXXXXXXXXXXXXXXXXXXXXXXXXXXXXXXXXXXXXXXXXXXX
